00000000000000000000000000000000000000000000000000000000000000000000000000000000
01111111111111111110011111111111111111100111111111111111111001111111111111111110
01111111111111111110011111111111111111100111111111111111111001111111111111111110
01111111111111111110011111111111111111100111111111111111111001111111111111111110
01111111111111111110011111111111111111100111111111111111111001111111111111111110
01111111111111111110011111111111111111100111111111111111111001111111111111111110
01111111111111111110011111111111111111100111111111111111111001111111111111111110
01111111111111111110011111111111111111100111111111111111111001111111111111111110
01111111111111011110011111111111110111100111111111111101111001111111111111011110
01111111111111011110011111111111110111100111111111111101111001111111111111011110
01111111111111011111111111111111110111100111111111111101111001111111111111011110
01111000000000011110011110000000000111100111100000000001111001111000000000011110
01111111111111011110011111111111110111100111111111111101111001111111111111011110
01111111111111011110011111111111110111100111111111111101111001111111111111011110
01111111111111011110011111111111110111100111111111111101111001111111111111011110
01111111111111111110011111111111111111100111111111111111111001111111111111111110
01111111111111111110011111111111111111100111111111111111111001111111111111111110
01111111111111111110011111111111111111100111111111111111111001111111111111111110
01111111111111111110011111111111111111100111111111111111111001111111111111111110
00000000000000000000000000000000000000000000000000000000000000000000000000000000
00000000000000000000000000000000000000000000000000000000000000000000000000000000
01111111111111111110011111111111111111100111111111111111111001111111111111111110
01111111111111111110011111111111111111100111111111111111111001111111111111111110
01111111111111111110011111111111111111100111111111111111111001111111111111111110
01111111111111111110011111111111111111100111111111111111111001111111111111111110
01111111111111111110011111111111111111100111111111111111111001111111111111111110
01111111111111111110011111111111111111100111111111111111111001111111111111111110
01111111111111111110011111111111111111100111111111111111111001111111111111111110
01111111111111011110011111111111110111100111111111111101111001111111111111011110
01111111111111011110011111111111110111100111111111111101111001111111111111011110
01111111111111011110011111111111110111100111111111111101111001111111111111011110
01111000000000011110011110000000000111100111100000000001111001111000000000011110
01111111111111011110011111111111110111100111111111111101111001111111111111011110
01111111111111011110011111111111110111100111111111111101111001111111111111011110
01111111111111011110011111111111110111100111111111111101111001111111111111011110
01111111111111111110011111111111111111100111111111111111111001111111111111111110
01111111111111111110011111111111111111100111111111111111111001111111111111111110
01111111111111111110011111111111111111100111111111111111111001111111111111111110
01111111111111111110011111111111111111100111111111111111111001111111111111111110
00000000000000000000000000000000000000000000000000000000000000000000000000000000
00000000000000000000000000000000000000000000000000000000000000000000000000000000
01111111111111111110011111111111111111100111111111111111111001111111111111111110
01111111111111111110011111111111111111100111111111111111111001111111111111111110
01111111111111111110011111111111111111100111111111111111111001111111111111111110
01111111111111111110011111111111111111100111111111111111111001111111111111111110
01111111111111111110011111111111111111100111111111111111111001111111111111111110
01111111111111111110011111111111111111100111111111111111111001111111111111111110
01111111111111111110011111111111111111100111111111111111111001111111111111111110
01111111111111011110011111111111110111100111111111111101111001111111111111011110
01111111111111011110011111111111110111100111111111111101111001111111111111011110
01111111111111011110011111111111110111100111111111111101111001111111111111011110
01111000000000011110011110000000000111100111100000000001111001111000000000011110
01111111111111011110011111111111110111100111111111111101111001111111111111011110
01111111111111011110011111111111110111100111111111111101111001111111111111011110
01111111111111011110011111111111110111100111111111111101111001111111111111011110
01111111111111111110011111111111111111100111111111111111111001111111111111111110
01111111111111111110011111111111111111100111111111111111111001111111111111111110
01111111111111111110011111111111111111100111111111111111111001111111111111111110
01111111111111111110011111111111111111100111111111111111111001111111111111111110
00000000000000000000000000000000000000000000000000000000000000000000000000000000
00000000000000000000000000000000000000000000000000000000000000000000000000000000
01111111111111111110011111111111111111100111111111111111111001111111111111111110
01111111111111111110011111111111111111100111111111111111111001111111111111111110
01111111111111111110011111111111111111100111111111111111111001111111111111111110
01111111111111111110011111111111111111100111111111111111111001111111111111111110
01111111111111111110011111111111111111100111111111111111111001111111111111111110
01111111111111111110011111111111111111100111111111111111111001111111111111111110
01111111111111111110011111111111111111100111111111111111111001111111111111111110
01111111111111011110011111111111110111100111111111111101111001111111111111011110
01111111111111011110011111111111110111100111111111111101111001111111111111011110
01111111111111011110011111111111110111100111111111111101111001111111111111011110
01111000000000011110011110000000000111100111100000000001111001111000000000011110
01111111111111011110011111111111110111100111111111111101111001111111111111011110
01111111111111011110011111111111110111100111111111111101111001111111111111011110
01111111111111011110011111111111110111100111111111111101111001111111111111011110
01111111111111111110011111111111111111100111111111111111111001111111111111111110
01111111111111111110011111111111111111100111111111111111111001111111111111111110
01111111111111111110011111111111111111100111111111111111111001111111111111111110
01111111111111111110011111111111111111100111111111111111111001111111111111111110
00000000000000000000000000000000000000000000000000000000000000000000000000000000
