00000000000000000000000000000000000000000000000000000000000000000000000000000000
02222222222222222220022222222222222222200222222222222222222002222222222222222220
02222222222222222220022222222222222222200222222222222222222002222222222222222220
02222222222222222220022222222222222222200222222222222222222002222222222222222220
02222222222222222220022222222222222222200222222222222222222002222222222222222220
02222222222222222220022222222222222222200222222222222222222002222222222222222220
02222222222222222220022222222222222222200222222222222222222002222222222222222220
02222222222222222220022222222222222222200222222222222222222002222222222222222220
02222222222222222220022222222222222222200222222222222222222002222222222222222220
02222222222222222220022222222222222222200222222222222222222002222222222222222220
02222222222222222222222222222222222222200222222222222222222002222222222222222220
02222222222222222220022222222222222222200222222222222222222002222222222222222220
02222222222222222220022222222222222222200222222222222222222002222222222222222220
02222222222222222220022222222222222222200222222222222222222002222222222222222220
02222222222222222220022222222222222222200222222222222222222002222222222222222220
02222222222222222220022222222222222222200222222222222222222002222222222222222220
02222222222222222220022222222222222222200222222222222222222002222222222222222220
02222222222222222220022222222222222222200222222222222222222002222222222222222220
02222222222222222220022222222222222222200222222222222222222002222222222222222220
00000000000000000000000000000000000000000000000000000000000000000000000000000000
00000000000000000000000000000000000000000000000000000000000000000000000000000000
02222222222222222220022222222222222222200222222222222222222002222222222222222220
02222222222222222220022222222222222222200222222222222222222002222222222222222220
02222222222222222220022222222222222222200222222222222222222002222222222222222220
02222222222222222220022222222222222222200222222222222222222002222222222222222220
02222222222222222220022222222222222222200222222222222222222002222222222222222220
02222222222222222220022222222222222222200222222222222222222002222222222222222220
02222222222222222220022222222222222222200222222222222222222002222222222222222220
02222222222222222220022222222222222222200222222222222222222002222222222222222220
02222222222222222220022222222222222222200222222222222222222002222222222222222220
02222222222222222220022222222222222222200222222222222222222002222222222222222220
02222222222222222220022222222222222222200222222222222222222002222222222222222220
02222222222222222220022222222222222222200222222222222222222002222222222222222220
02222222222222222220022222222222222222200222222222222222222002222222222222222220
02222222222222222220022222222222222222200222222222222222222002222222222222222220
02222222222222222220022222222222222222200222222222222222222002222222222222222220
02222222222222222220022222222222222222200222222222222222222002222222222222222220
02222222222222222220022222222222222222200222222222222222222002222222222222222220
02222222222222222220022222222222222222200222222222222222222002222222222222222220
00000000000000000000000000000000000000000000000000000000000000000000000000000000
00000000000000000000000000000000000000000000000000000000000000000000000000000000
02222222222222222220022222222222222222200222222222222222222002222222222222222220
02222222222222222220022222222222222222200222222222222222222002222222222222222220
02222222222222222220022222222222222222200222222222222222222002222222222222222220
02222222222222222220022222222222222222200222222222222222222002222222222222222220
02222222222222222220022222222222222222200222222222222222222002222222222222222220
02222222222222222220022222222222222222200222222222222222222002222222222222222220
02222222222222222220022222222222222222200222222222222222222002222222222222222220
02222222222222222220022222222222222222200222222222222222222002222222222222222220
02222222222222222220022222222222222222200222222222222222222002222222222222222220
02222222222222222220022222222222222222200222222222222222222002222222222222222220
02222222222222222220022222222222222222200222222222222222222002222222222222222220
02222222222222222220022222222222222222200222222222222222222002222222222222222220
02222222222222222220022222222222222222200222222222222222222002222222222222222220
02222222222222222220022222222222222222200222222222222222222002222222222222222220
02222222222222222220022222222222222222200222222222222222222002222222222222222220
02222222222222222220022222222222222222200222222222222222222002222222222222222220
02222222222222222220022222222222222222200222222222222222222002222222222222222220
02222222222222222220022222222222222222200222222222222222222002222222222222222220
00000000000000000000000000000000000000000000000000000000000000000000000000000000
00000000000000000000000000000000000000000000000000000000000000000000000000000000
02222222222222222220022222222222222222200222222222222222222002222222222222222220
02222222222222222220022222222222222222200222222222222222222002222222222222222220
02222222222222222220022222222222222222200222222222222222222002222222222222222220
02222222222222222220022222222222222222200222222222222222222002222222222222222220
02222222222222222220022222222222222222200222222222222222222002222222222222222220
02222222222222222220022222222222222222200222222222222222222002222222222222222220
02222222222222222220022222222222222222200222222222222222222002222222222222222220
02222222222222222220022222222222222222200222222222222222222002222222222222222220
02222222222222222220022222222222222222200222222222222222222002222222222222222220
02222222222222222220022222222222222222200222222222222222222002222222222222222220
02222222222222222220022222222222222222200222222222222222222002222222222222222220
02222222222222222220022222222222222222200222222222222222222002222222222222222220
02222222222222222220022222222222222222200222222222222222222002222222222222222220
02222222222222222220022222222222222222200222222222222222222002222222222222222220
02222222222222222220022222222222222222200222222222222222222002222222222222222220
02222222222222222220022222222222222222200222222222222222222002222222222222222220
02222222222222222220022222222222222222200222222222222222222002222222222222222220
02222222222222222220022222222222222222200222222222222222222002222222222222222220
00000000000000000000000000000000000000000000000000000000000000000000000000000000
