00000000000000000000
01111111111111111110
01111111111111111110
01111111111111111110
01111333311111111110
01111333311111111110
01111333311111111110
01111333311111111110
01111111111111111110
01111111111111111110
01111111111111111110
01111111111111111110
01111111444411155110
01111111444411155110
01111111444411111110
01111111444411166110
01111111444411166110
01111111111111111110
01111111111111111110
00000000000000000000
