00000000000000000000
02222222222222222220
02222222222222222220
02222000000222222220
02222222220222222220
02222222220222222220
02222222220222222220
02222222222222222220
02222222220222222220
02222222220222222220
02222220000002222220
02222222222222222220
02222222222222222220
02222222222222222220
02222222222222222220
02222222222222222220
02220000222000022220
02222222222222222220
02222222222222222220
00000000000000000000
