00000000000000000000
01111111111111111110
01111111111111111110
01111111111111111110
01111111111111111110
01111111111111111110
01111111111111111110
01111111111111111110
01111000011111111110
01111111000111111110
01111111111111111110
01111111111111111110
01111111111111111110
01111111111111111110
01111111111111111110
01111101110111111110
01111111111111111110
01110000000001111110
01111111111111111110
00000000000000000000
