00000000000000000000
01111111111111111110
01111111011111111110
01114115011111111110
01114115011111111110
33111111011111111110
01113311111111111110
01113311111111111110
01111111111111111110
01111111111111111110
01111111011111111110
01114115011111111110
01114115011111111110
33111111011111111110
01113311111111111110
01113311111111111110
01111111111111111110
01113311111111111110
01111111111111111110
00000000000000000000
