0000000000
0111111110
0111111100
0111411500
0111411500
3311111100
0111331110
0111331110
0111111110
0000000000
