0000000000000000000000000
0222222222222222222000000
0222222222222222222000000
0222222222222222222000000
0222222222222222022000000
0220222222222222022000000
0220222222222222022000000
0220222222022222022000000
0220222222022222222000000
0220222222022222222000000
0220000200022222222000000
0222222222022222022000000
0222222222022222022000000
0222222222222222022000000
0222222222222222022000000
0222222222222222222000000
0222222222222222222000000
0222222222222222222000000
0222222222222222222000000
0000000000000000000000000
0000000000000000000000000
0000000000000000000000000
0000000000000000000000000
0000000000000000000000000
0000000000000000000000000

